LibraryAddMenu=Añadir Biblioteca
PathAddition=Añadir Nuevo Camino
AdditionProcess=Agregando
AdminAccountDescriptor=Admin
AlbumCollection=Álbumes
PasswordSetupPrompt=Vale {}, vamos a configurar una contraseña.
ArtistRegistry=Artistas
AverageFileTime=Tiempo Promedio Por Archivo
BackNavigation=Atrás
BackgroundTextColorSetting=color del texto de fondo
SSLCertificatePathEntrySecond=certificado (o ingresa nada para cancelar)
ServerRestartWarning=¡Cambiar esta configuración requerirá reiniciar el servidor!
ConnectionCheckStatus=Comprobando Conexión...
ColorSelection=Elige un color para cambiar
ColorProperty=color
ColorOptions=Colores
CompletionStatus=¡Completo!
HTTPSConfigOption=Configurar HTTPS
PasswordConfirmation=Confirma la contraseña
MongoDBConnectStatus=Conectar a MongoDB
ServerConnectionFailure=¡No se pudo conectar a ese servidor!
NavigationControls=Controles: Flechas Arriba/Abajo, <-/->, Enter(Guardar), Esc(Atrás)
SimpleNavigationControls=Controles: Flechas Arriba/Abajo, Enter
BackEscapeControl=Controles: Esc(Atrás)
FileStatusDisplay=Archivo Actual
FolderStatusDisplay=Carpeta Actual
MongoDBConnectionString=Cadena de conexión actual de MongoDB
URLDisplay=URL Actual
DatabaseResetOption=Reinicio de Base de Datos
DebugModeToggle=depurar
DeletionStepStatus=Paso de Eliminación, Terminando~
FileCountNote=dependiendo de cuántos archivos tengas.
SSLDisableOption=Deshabilitar SSL
ColorEditOption=Editar Colores
LibraryPathEditOption=Editar Caminos de Biblioteca
ListeningURLEditOption=Editar URL de Escucha
MongoDBConnectionEditOption=Editar Conexión de MongoDB
SSLConfigEditOption=Editar Configuración SSL
UserEditor=Editar Usuarios
LibraryPathEntry=Ingresa un nuevo camino de biblioteca
StringEntryPrompt=Ingresa una nueva cadena o nada para mantener la cadena actual
URLListEntry=Ingresa nuevas URLs separadas por ";" o nada para mantener la cadena actual
DefaultMongoDBEntry=Ingresa nada para el predeterminado
ErrorColorSetting=color de error
MongoDBConnectionError=Error: ¡No se pudo conectar a MongoDB, está correcta la cadena de conexión?
ExitOption=Salir
FirstTimeSetupPrompt=Primero, ¿te gustaría usar
FoundStatus=Encontrado
FullScanOption=Escaneo Completo
WelcomeMessage=¡Hola, bienvenido a
HighlightColorSetting=color de resaltado
ColorVisibilityCheck=Si ahora no ves color en ninguna parte, deberías seleccionar no.
MenuColorQuery=¿en menús?
InitializationStatus=Inicio
CertificatePasswordError=Certificado o Contraseña Inválidos
PathValidationError=Camino Inválido, Por favor intenta de nuevo (O ingresa nada para salir)
URLValidationError=URL Inválida
ScanDurationNote=Puede
RescanRequirement=No debería tomar mucho tiempo pero requerirá que vuelvas a escanear tus archivos.
MusicStorageQuery=Por último, ¿dónde almacenas tu música?
SetupUsernamePrompt=Vamos a configurarte, empezando con tu nombre de usuario.
LibraryOption=Bibliotecas
LibraryScanInitiation=¡Escaneo de biblioteca iniciado!
LibraryScannerTool=Escáner de Biblioteca
ListeningURLDisplay=URL de Escucha
SettingsLoadStatus=Cargar configuraciones
SettingsLoadingProcess=Cargando Configuraciones...
MelonTitle=Melon
MelonTitleColorSetting=color del título de Melon
MongoDBOption=MongoDB
NotApplicableStatus=N/A
NewColorDisplay=Color Nuevo
SSLPasswordEntry=A continuación, ingresa la contraseña de tu Certificado SSL (o ingresa nada para cancelar)
MongoDBSetupPrompt=A continuación, necesitamos conectarte a una instancia de MongoDB.
NegativeConfirmation=No
NoPathWarning=¡No hay caminos de biblioteca para buscar!
NormalTextColorSetting=color de texto normal
AdminCreationNote=de esta instancia de Melon, y se puede cambiar en cualquier momento
OldColorDisplay=Color Antiguo
PasswordSetting=Contraseña
PasswordMismatchError=Las contraseñas no coinciden, por favor intenta de nuevo.
SSLCertificatePathEntryFirst=Por favor ingresa la ruta a tu
TagPreparationStatus=Preparando etiquetas de Artista y Género
ContinuationPrompt=Presiona cualquier tecla para continuar...
ReturnPrompt=Presiona cualquier tecla para regresar al menú
StartConfirmation=¿Listo para Empezar?
DatabaseResetConfirmation=Reiniciar BD
ScanStatus=Escaneado
ScannerProgressDisplay=Progreso del Escáner
PathDeletionSelection=Selecciona un camino para eliminarlo
DefaultColorReset=Establecer todos los colores a sus valores predeterminados
ColorSetPromptStart=Establece el
HTTPSRequirementNote=Configurar HTTPS requiere un Certificado SSL válido.
SettingsOption=Configuraciones
SetupProcess=Configuración
ShadedTextColorSetting=color de texto sombreado
ShortScanOption=Escaneo Corto
TrackSortingStatus=Ordenando Pistas y Lanzamientos
SSLConfigStatus=SSL ya está configurado, ¿te gustaría deshabilitarlo o editarlo?
SystemStatusDisplay=Estado
TimeConsumptionNote=puede tardar un tiempo
ScannerRunningCheck=¿El escáner ya está en funcionamiento, ver progreso?
ShortScanExplanation=El escaneo corto solo escaneará archivos recientemente actualizados o archivos no presentes en la db.
ConnectionStringNote=Esto puede ser local o a través de atlas, usando una cadena de conexión
AdminConsideration=Esto se considerará el
AppLoginInstruction=Esto se usará para iniciar sesión en aplicaciones. Cuando quieras añadir otros usuarios, tendrán su propia información de inicio de sesión.
DatabaseRemovalWarning=Esto eliminará todas las entradas de la db.
FullLibraryScanInitiation=Esto iniciará un escaneo de todos los caminos guardados y sus subdirectorios.
TimeLeftDisplay=Tiempo Restante
TimeoutSetting=Tiempo de Espera
TracksCollection=Pistas
UnknownStatus=Desconocido
UnknownAlbumStatus=Álbum Desconocido
UnknownArtistStatus=Artista Desconocido
UnidentifiedAlbum=Álbum desconocido
UpdateProcess=Actualizando
UserManagement=Usuarios
NotFoundError=¡no fue encontrado!
ResetConfirmation=¿Todavía te gustaría reiniciar?
PositiveConfirmation=Sí
MultiplePathEntry=Puedes ingresar múltiples caminos si es necesario, solo ingresa nada cuando hayas terminado.
PathRequirementReminder=¡Vas a necesitar agregar al menos un camino!
UsernameConfirmation=Tu nombre de usuario es {}, ¿es correcto?
HeadlessSetupRequired=Melon debe pasar por la configuración primero, la cual no se puede mostrar en modo sin cabeza.
HeadlessSetupInstructions=Por favor, ejecuta Melon sin el modo sin cabeza primero para completar la configuración.
CurrentLanguageDefault=El idioma actual está configurado en
LanguageInstructions=Ingresa un código de idioma válido (en, es) para cambiar el idioma.
LanguageError=No se encontró soporte para {} en Melón.
DefaultLanguageOption=Cambiar Idioma Predeterminado
CollectionStepStatus=Actualización de colecciones
CheckDbVersioningStatus=Comprobando compatibilidad con la base de datos