LibraryAddMenu=Add Library
PathAddition=Add New Path
AdditionProcess=Adding
AdminAccountDescriptor=Admin
AlbumCollection=Albums
PasswordSetupPrompt=Alright {}, let's set up a password.
ArtistRegistry=Artists
AverageFileTime=Avg Time Per File
BackNavigation=Back
BackgroundTextColorSetting=background text color
SSLCertificatePathEntrySecond=certificate (or enter nothing to cancel)
ServerRestartWarning=Changing this setting will require a server restart!
ConnectionCheckStatus=Checking Connection...
ColorSelection=Choose a color to change
ColorProperty=color
ColorOptions=Colors
CompletionStatus=Complete!
HTTPSConfigOption=Configure HTTPS
PasswordConfirmation=Confirm password
MongoDBConnectStatus=Connect to MongoDB
ServerConnectionFailure=Couldn't connect to that server!
NavigationControls=Ctrls: Arrow Keys ↑/↓, <-/->, Enter(Save), Esc(Back)
SimpleNavigationControls=Ctrls: Arrow Keys ↑/↓, Enter
BackEscapeControl=Ctrls: Esc(Back)
FileStatusDisplay=Current File
FolderStatusDisplay=Current Folder
MongoDBConnectionString=Current MongoDB connection string
URLDisplay=Current URL
DatabaseResetOption=Database Reset
DebugModeToggle=debug
DeletionStepStatus=Removing missing files
FileCountNote=depending on how many files you have.
SSLDisableOption=Disable SSL
ColorEditOption=Edit Colors
LibraryPathEditOption=Edit Library Paths
ListeningURLEditOption=Edit Listening URL
MongoDBConnectionEditOption=Edit MongoDB Connection
SSLConfigEditOption=Edit SSL Config
UserEditor=Edit Users
LibraryPathEntry=Enter a new library path
StringEntryPrompt=Enter a new string or nothing to keep the current string
URLListEntry=Enter new urls separated by ";" or nothing to keep the current string
DefaultMongoDBEntry=Enter nothing for default
ErrorColorSetting=error color
MongoDBConnectionError=Error: Couldn't connect to MongoDB, is the connection string correct?
ExitOption=Exit
ExitUIOption=Exit Console
ExitMelonOption=Shutdown Melon
FirstTimeSetupPrompt=First thing, would you like to use
FoundStatus=Found
FullScanOption=Full Scan
WelcomeMessage=Heyo, welcome to
HighlightColorSetting=highlight color
ColorVisibilityCheck=If you don't see color anywhere now, you should select no.
MenuColorQuery=in menus?
InitializationStatus=Init
CertificatePasswordError=Invalid Cert or Password
PathValidationError=Invalid Path, Please try again (Or enter nothing to quit)
URLValidationError=Invalid URL
ScanDurationNote=It may
RescanRequirement=It shouldn't take long but will require you to rescan your files.
MusicStorageQuery=Lastly, where do you store your music?
SetupUsernamePrompt=Let's get you setup, starting with your username.
LibraryOption=Libraries
LibraryScanInitiation=Library scan started!
LibraryScannerTool=Library Scanner
ListeningURLDisplay=Listening URL
SettingsLoadStatus=Load settings
SettingsLoadingProcess=Loading Settings...
MelonTitle=Melon
MelonTitleColorSetting=Melon title color
MongoDBOption=MongoDB
NotApplicableStatus=N/A
NewColorDisplay=New Color
SSLPasswordEntry=Next, enter the password to your SSL Certificate (or enter nothing to cancel)
MongoDBSetupPrompt=Next, we need to connect you to a MongoDb instance.
NegativeConfirmation=No
NoPathWarning=No library paths to search!
NormalTextColorSetting=normal text color
AdminCreationNote=of this Melon instance, and can be changed anytime
OldColorDisplay=Old Color
PasswordSetting=Password
PasswordMismatchError=Passwords do not match, please try again.
SSLCertificatePathEntryFirst=Please enter the path to your
TagPreparationStatus=Preparing Artist and Genre tags
ContinuationPrompt=Press any key to continue...
ReturnPrompt=Press any key to return to the menu
StartConfirmation=Ready to Start?
DatabaseResetConfirmation=Reset DB
ScanStatus=Scanned
ScannerProgressDisplay=Scanner Progress
PathDeletionSelection=Select a path to delete it
DefaultColorReset=Set all colors back to their defaults
ColorSetPromptStart=Set the
HTTPSRequirementNote=Setting up HTTPS requires a valid SSL Certificate.
SettingsOption=Settings
SetupProcess=Setup
ShadedTextColorSetting=shaded text color
ShortScanOption=Short Scan
TrackSortingStatus=Sorting Tracks and Releases
SSLConfigStatus=SSL is already configured, would you like to disabled or edit it?
SystemStatusDisplay=Status
TimeConsumptionNote=take awhile
ScannerRunningCheck=The scanner is already running, view progress?
ShortScanExplanation=The short scan will only scan recently updated files or files not already in the db.
ConnectionStringNote=This can be local or through atlas, using a connection string
AdminConsideration=This will be considered the
AppLoginInstruction=This will be used to log you in to apps. When you want to add other users, they'll have their own login info.
DatabaseRemovalWarning=This will remove all of the db entries.
FullLibraryScanInitiation=This will start a scan of all saved paths and their subdirectories.
TimeLeftDisplay=Time Left
TimeoutSetting=Timeout
TracksCollection=Tracks
UnknownStatus=Unknown
UnknownAlbumStatus=Unknown Album
UnknownArtistStatus=Unknown Artist
UnidentifiedAlbum=Unkown album
UpdateProcess=Updating
UserManagement=Users
NotFoundError=was not found!
ResetConfirmation=Would you still like to reset?
PositiveConfirmation=Yes
MultiplePathEntry=You can enter multiple paths if needed, just enter nothing when you're done.
PathRequirementReminder=You're going to need to add at least one path!
UsernameConfirmation=Your username is {}, is that right?
HeadlessSetupRequired=Melon must go through setup first, which cannot show in headless mode.
HeadlessSetupInstructions=Please run melon without headless mode first to complete setup.
CurrentLanguageDefault=The current language is set to
LanguageInstructions=Enter a valid language code (en,es) to swap language.
LanguageError=No support for {} found in Melon.
DefaultLanguageOption=Change Default Language
CollectionStepStatus=Updating Collections
CheckDbVersioningStatus=Checking Database Compatibility
LoadPluginsStatus=Load Plugins
ViewPluginsOption=View Plugins
NameDisplay=Name
AuthorsDisplay=Authors
VersionDisplay=Version
DescriptionDisplay=Description
EnablePluginOption=Enable plugin
DisablePluginOption=Disable plugin
ReloadAllPluginsOption=Reload all plugins
RescanPluginsFolderOption=Rescan plugins folder
ScannerSettingsOption=Melon Scanner Settings
NetworkSettingsOption=Network Settings
MenuCustomizationOption=Menu Customization
PluginsOption=Plugins
PluginsSettingsOption=Plugins Settings
OpenMelonFolderOption=Open Melon folder
DatabaseMenu=Database Settings
DbBackupOption=Backup Database
DbLoadBackupOption=Load From Backup
PlaylistExportOption=Export Playlist
PlaylistImportOption=Import Playlist
ExportPlaylistIdRequest=Enter the id of the playlist or collection to export.
PlaylistNotFound=Playlist not found
FileFormatSelection=Select the file format to export to.
PlaylistExportError=Playlist could not be exported!
ImportPlaylistFileRequest=Enter the path to a playlist file or folder of files (Supports m3u/m3u8, pls, xml/xspf)
ImportPlaylistControls=[Enter nothing go back]
FileNotFound=File not found
FileParseError=Could not parse this file!
PlaylistNameRequest=Give this playlist a name.
PlaylistUserRequest=Select a user to set as the playlist(s) owner.
ImportProgress=Importing...
GenerationDescription=Generated from
ImportBackupSelection=Select a backup to import. (Showing results from Melon/Exports/DbBackups)
ScannerFinding=Finding Files
ScannerScanning=Scanning Files
ExperimentalScannerEnable=Enable Experimental V2
ExperimentalScannerDisable=Disable Experimental V2
WritingTracksStatus=Writing Tracks
WritingAlbumsStatus=Writing Albums
WritingArtistsStatus=Writing Artists
CreateAlbumsStatus=Creating Albums
CreateArtistsStatus=Creating Artists
UpdateTracksStatus=Updating Tracks
UpdateLyricsStatus=Setting Lyrics
IncompatibleCollections=The following database collections are not compatible with this version of Melon.
ConvertCollectionsPrompt=Would you like to convert them?
ConversionWarning=Documents found are not compatible with this version of Melon. Launch the UI to convert.
RelaunchHeadlessMode=Relaunch headless mode with -c or --allowConversion to convert their documents to a compatible version.
BackingUpDatabase=Backing up the database.
DatabaseBackupFailed=Database backup failed! Make sure you have space on your drive and that MongoDb is connected.
BackupCreated=Backed up created.
Converting=Converting
ConversionCompleted=Conversion Completed.
MelonMediaServer=Melon Media Server
VisitGitHub=Visit the GitHub for documentation
UsageOptions=Usage: Melon [OPTIONS]
OptionsHeader=Options
HelpMenu=Show this help menu and exit.
LaunchNoUI=Launch the application with no user interface.
ForceOOBE=Force the Out-Of-Box Experience (OOBE) on launch.
DisablePlugins=Disable all plugins on startup.
ShowVersion=Show the current version of the Melon Media Server.
LaunchWithLang=Launch the application with the specified language. Example: "--lang EN" for English.
EnableDBConversion=If there is a database version incompatibility, enable converting the database to a compatible version.
VersionLabel=Version
BetaLabel=Beta
BuildDateLabel=Build Date
LoadDbStatus=Loading Database
ReleaseInfoError=Could not get the latest release information.
CheckForUpdates=Check For Updates
ErrorOccurred=An error occurred
CheckingGitHub=Checking GitHub for releases.
NoUpdates=No updates found.
Current=Current
Latest=Latest
ReleaseNotes=Release Notes:
UpdateAvailable=Update Available
UpdatePrompt=Would you like to update?
MissingUpdater=Couldn't launch the updater, is it missing?
ScannerOption=Scanner
ShowConsoleOption=Show Console
ArtistSplitIndicatorsDescOne=These are the indicators that split artists in your metadata.
ArtistSplitIndicatorsDescTwo=For exameple: Artist 1, Artist 2 feat. Artist 3
CurrentListOfIndicators=Current List of Indicators:
ListEntryDesc=Enter any new ones you want to add, or enter a number to delete that item.
GenreSplitIndicatorsDescOne=These are the indicators that split genres in your metadata.
GenreSplitIndicatorsDescTwo=For exameple: Genre 1, Genre 2//Genre 4
ArtistSplitIndicatorsOption=Artist Split Indicators
GenreSplitIndicatorsOption=Genre Split Indicators
